apple - elma
cat - kedi
house - ev
book - kitap
dog - köpek
table - masa
car - araba
computer - bilgisayar
pencil - kalem
chair - sandalye
school - okul
tree - ağaç
bird - kuş
sun - güneş
flower - çiçek
water - su
friend - arkadaş
city - şehir
music - müzik
watch - saat
beach - plaj
language - dil
job - iş
game - oyun
wallet - cüzdan
key - anahtar
picture - resim
bed - yatak
mountain - dağ
bread - ekmek
phone - telefon
movie - film
road - yol
family - aile
shirt - gömlek
rain - yağmur
baby - bebek
doctor - doktor
bike - bisiklet
dream - hayal
gift - hediye
hat - şapka
job - iş
king - kral
lamp - lamba
moon - ay
newspaper - gazete
orange - portakal
park - park
train - tren